{
    "width": 12,
    "height": 9,
    "tiles": [
      [1,1,1,1,1,1,1,1,1,1,1,1],
      [1,0,0,0,0,0,0,0,0,0,0,1],
      [1,0,1,1,1,1,1,1,1,1,0,1],
      [1,0,1,0,0,0,0,0,0,1,0,1],
      [1,0,1,0,1,1,1,1,0,1,0,1],
      [1,0,1,0,0,0,0,1,0,1,0,1],
      [1,0,0,0,1,1,0,0,0,1,0,1],
      [1,0,0,0,0,0,0,0,0,0,0,1],
      [1,1,1,1,1,1,1,1,1,1,1,1]
    ],
    "player_start": [1,1],
    "exit_pos": [10,7],
    "jelly_count": 4,
    "enemies": [
      { "pos": [5,3], "speed": 2.0, "patrol": [[5,3],[8,3]] },
      { "pos": [3,6], "speed": 2.0, "patrol": [[3,6],[9,6]] }
    ]
  }
  