{
    "width": 16,
    "height": 10,
    "tiles": [
      [1,1,1,1,1,1,1,1,1,1,1,1,1,1,1,1],
      [1,0,0,0,0,0,0,0,0,0,0,0,0,0,0,1],
      [1,0,1,1,1,1,0,1,1,1,1,1,0,1,0,1],
      [1,0,1,0,0,0,0,0,0,0,0,1,0,1,0,1],
      [1,0,1,0,1,1,1,1,1,1,0,1,0,1,0,1],
      [1,0,0,0,0,0,0,1,0,0,0,0,0,1,0,1],
      [1,0,0,0,0,0,0,1,0,0,0,0,0,1,0,1],
      [1,0,0,0,0,0,0,1,0,0,0,0,0,1,0,1],
      [1,0,0,0,0,0,0,0,0,0,0,0,0,0,0,1],
      [1,1,1,1,1,1,1,1,1,1,1,1,1,1,1,1]
    ],
    "player_start": [1,1],
    "exit_pos": [14,8],
    "jelly_count": 6,
    "enemies": [
      { "pos": [5,2], "speed": 2.0, "patrol": [[5,2],[5,7]] },
      { "pos": [10,2], "speed": 2.0, "patrol": [[10,2],[10,7]] },
      { "pos": [7,5], "speed": 2.0, "patrol": [[2,5],[13,5]] }
    ]
  }
  