{
  "width": 16,
  "height": 10,
  "player_start": [1, 1],
  "exit_pos": [14, 8],
  "enemies": [
    { "pos": [4, 3], "speed": 2 },
    { "pos": [10, 2], "speed": 2 },
    { "pos": [12, 6], "speed": 2 }
  ],
  "tiles": [
    [1,1,1,1,1,1,1,1,1,1,1,1,1,1,1,1],
    [1,0,0,0,0,1,0,0,0,0,1,0,0,0,0,1],
    [1,0,1,1,0,1,0,1,1,0,1,0,1,1,0,1],
    [1,0,0,1,0,0,0,1,0,0,0,0,1,0,0,1],
    [1,1,0,1,1,1,0,1,0,1,1,0,1,0,1,1],
    [1,0,0,0,0,0,0,1,0,0,0,0,1,0,0,1],
    [1,0,1,1,0,1,0,1,1,1,0,1,1,1,0,1],
    [1,0,0,0,0,0,0,0,0,1,0,0,0,0,0,1],
    [1,0,1,1,1,1,1,1,0,1,1,1,1,1,0,1],
    [1,1,1,1,1,1,1,1,1,1,1,1,1,1,1,1]
  ]
}