{
    "width": 12,
    "height": 8,
    "tiles": [
      [1,1,1,1,1,1,1,1,1,1,1,1],
      [1,0,0,0,0,0,1,0,0,0,0,1],
      [1,0,1,1,1,0,1,0,1,1,0,1],
      [1,0,1,0,0,0,0,0,1,0,0,1],
      [1,0,1,0,1,1,1,0,1,1,0,1],
      [1,0,0,0,0,0,0,0,0,0,0,1],
      [1,0,0,1,1,1,1,1,0,0,0,1],
      [1,1,1,1,1,1,1,1,1,1,1,1]
    ],
    "player_start": [1,1],
    "exit_pos": [10,5],
    "jelly_count": 3,
    "enemies": [
      { "pos": [6,1], "speed": 2.0, "patrol": [[6,1],[6,5]] }
    ]
  }
  