{
  "width": 18,
  "height": 12,
  "player_start": [1, 1],
  "exit_pos": [16, 10],
  "enemies": [
    { "pos": [8, 3], "speed": 2 }
  ],
  "tiles": [
    [1,1,1,1,1,1,1,1,1,1,1,1,1,1,1,1,1,1],
    [1,0,0,0,1,0,0,0,0,0,0,1,0,0,0,0,0,1],
    [1,0,1,0,1,0,1,1,1,1,0,1,0,1,1,1,0,1],
    [1,0,1,0,0,0,0,0,0,1,0,0,0,0,0,1,0,1],
    [1,0,1,1,1,1,1,1,0,1,1,1,1,1,0,1,0,1],
    [1,0,0,0,0,0,0,1,0,0,0,1,0,1,0,0,0,1],
    [1,1,1,1,1,1,0,1,1,1,0,1,0,1,0,1,1,1],
    [1,0,0,0,0,1,0,0,0,1,0,1,0,0,0,1,0,1],
    [1,0,1,1,0,1,0,1,1,1,0,1,0,1,1,1,0,1],
    [1,0,0,1,0,0,0,0,0,1,0,0,0,1,0,1,0,1],
    [1,1,0,0,0,1,1,1,0,0,0,1,0,0,0,0,0,1],
    [1,1,1,1,1,1,1,1,1,1,1,1,1,1,1,1,1,1]
  ]
}