{
    "width": 14,
    "height": 10,
    "tiles": [
      [1,1,1,1,1,1,1,1,1,1,1,1,1,1],
      [1,0,0,0,0,0,0,0,0,0,0,0,0,1],
      [1,0,1,1,1,1,0,1,1,1,1,1,0,1],
      [1,0,1,0,0,0,0,0,0,0,0,1,0,1],
      [1,0,1,0,1,1,1,1,1,1,0,1,0,1],
      [1,0,0,0,0,0,0,1,0,0,0,0,0,1],
      [1,0,1,1,1,1,0,1,1,1,1,1,0,1],
      [1,0,0,0,0,0,0,0,0,1,0,0,0,1],
      [1,0,0,0,0,0,0,0,0,0,0,0,0,1],
      [1,1,1,1,1,1,1,1,1,1,1,1,1,1]
    ],
    "player_start": [1,1],
    "exit_pos": [12,8],
    "jelly_count": 5,
    "enemies": [
      { "pos": [7,3], "speed": 2.0, "patrol": [[7,3],[11,3]] },
      { "pos": [3,6], "speed": 2.0, "patrol": [[3,6],[9,6]] },
      { "pos": [8,7], "speed": 2.0, "patrol": [[8,7],[12,7]] }
    ]
  }
  