{
  "width": 14,
  "height": 14,
  "player_start": [1, 1],
  "exit_pos": [12, 12],
  "enemies": [
    { "pos": [7, 3], "speed": 2 }
  ],
  "tiles": [
    [1,1,1,1,1,1,1,1,1,1,1,1,1,1],
    [1,0,0,0,1,0,0,0,0,0,0,1,0,1],
    [1,0,1,0,1,0,1,1,1,1,0,1,0,1],
    [1,0,1,0,0,0,0,0,0,1,0,0,0,1],
    [1,0,1,1,1,1,1,1,0,1,1,1,0,1],
    [1,0,0,0,0,0,0,1,0,0,0,1,0,1],
    [1,1,1,1,1,1,0,1,1,1,0,1,0,1],
    [1,0,0,0,0,1,0,0,0,1,0,1,0,1],
    [1,0,1,1,0,1,0,1,1,1,0,1,0,1],
    [1,0,0,1,0,0,0,0,0,1,0,1,0,1],
    [1,1,0,0,0,1,1,1,0,0,0,1,0,1],
    [1,0,0,1,0,0,0,1,1,1,0,1,0,1],
    [1,0,0,0,0,1,0,0,0,1,0,0,0,1],
    [1,1,1,1,1,1,1,1,1,1,1,1,1,1]
  ]
}