{
  "width": 10,
  "height": 10,
  "player_start": [1, 1],
  "exit_pos": [8, 8],
  "enemies": [
    { "pos": [5, 2], "speed": 1 },
    { "pos": [7, 6], "speed": 1 }
  ],
  "tiles": [
    [1,1,1,1,1,1,1,1,1,1],
    [1,0,0,0,1,0,0,0,0,1],
    [1,0,1,0,1,0,1,1,0,1],
    [1,0,1,0,0,0,0,1,0,1],
    [1,0,1,1,1,1,0,1,0,1],
    [1,0,0,0,0,1,0,1,0,1],
    [1,1,1,1,0,1,0,0,0,1],
    [1,0,0,0,0,0,1,1,0,1],
    [1,0,1,1,1,0,0,0,0,1],
    [1,1,1,1,1,1,1,1,1,1]
  ]
}