{
  "width": 8,
  "height": 8,
  "player_start": [1, 1],
  "exit_pos": [6, 6],
  "enemies": [
    { "pos": [3, 3], "speed": 1 }
  ],
  "tiles": [
    [1,1,1,1,1,1,1,1],
    [1,0,0,0,1,0,0,1],
    [1,0,1,0,1,0,0,1],
    [1,0,1,0,0,0,1,1],
    [1,0,0,0,1,0,0,1],
    [1,1,0,1,1,0,0,1],
    [1,0,0,0,0,0,0,1],
    [1,1,1,1,1,1,1,1]
  ]
}