{
  "width": 12,
  "height": 12,
  "player_start": [1, 1],
  "exit_pos": [10, 10],
  "enemies": [
    { "pos": [6, 3], "speed": 1 },
    { "pos": [9, 8], "speed": 1 }
  ],
  "tiles": [
    [1,1,1,1,1,1,1,1,1,1,1,1],
    [1,0,0,0,1,0,0,0,0,0,0,1],
    [1,0,1,0,1,0,1,1,1,1,0,1],
    [1,0,1,0,0,0,0,0,0,1,0,1],
    [1,0,1,1,1,1,1,1,0,1,0,1],
    [1,0,0,0,0,0,0,1,0,1,0,1],
    [1,1,1,1,1,1,0,1,0,1,0,1],
    [1,0,0,0,0,1,0,1,0,0,0,1],
    [1,0,1,1,0,1,0,1,1,1,0,1],
    [1,0,0,1,0,0,0,0,0,1,0,1],
    [1,1,0,0,0,1,1,1,0,0,0,1],
    [1,1,1,1,1,1,1,1,1,1,1,1]
  ]
}