{
    "width": 10,
    "height": 8,
    "tiles": [
      [1,1,1,1,1,1,1,1,1,1],
      [1,0,0,0,0,0,0,0,0,1],
      [1,0,1,1,0,1,1,1,0,1],
      [1,0,1,0,0,0,0,1,0,1],
      [1,0,1,0,1,1,0,0,0,1],
      [1,0,0,0,0,1,0,1,0,1],
      [1,0,0,0,0,0,0,0,0,1],
      [1,1,1,1,1,1,1,1,1,1]
    ],
    "player_start": [1,1],
    "exit_pos": [8,6],
    "jelly_count": 3,
    "enemies": [
      { "pos": [5,2], "speed": 2.0, "patrol": [[5,2],[5,5]] }
    ]
  }
  