{
  "width": 16,
  "height": 6,
  "player_start": [1, 1],
  "exit_pos": [14, 4],
  "enemies": [
    { "pos": [2, 3], "speed": 1 }
  ],
  "tiles": [
    [1,1,1,1,1,1,1,1,1,1,1,1,1,1,1,1],
    [1,0,0,0,0,1,0,0,0,0,1,0,0,0,0,1],
    [1,0,1,1,0,1,0,1,1,0,1,0,1,1,0,1],
    [1,0,0,1,0,0,0,1,0,0,0,0,1,0,0,1],
    [1,1,0,1,1,1,0,1,0,1,1,0,1,0,0,1],
    [1,1,1,1,1,1,1,1,1,1,1,1,1,1,1,1]
  ]
}