{
    "width": 14,
    "height": 9,
    "tiles": [
      [1,1,1,1,1,1,1,1,1,1,1,1,1,1],
      [1,0,0,0,0,0,0,0,0,0,0,0,0,1],
      [1,0,1,1,1,1,0,1,1,1,1,1,0,1],
      [1,0,0,0,0,1,0,0,0,0,0,1,0,1],
      [1,0,1,1,0,1,1,1,1,1,0,1,0,1],
      [1,0,0,1,0,0,0,0,0,1,0,0,0,1],
      [1,0,0,0,0,1,1,1,0,1,0,1,0,1],
      [1,0,0,0,0,0,0,0,0,1,0,0,0,1],
      [1,1,1,1,1,1,1,1,1,1,1,1,1,1]
    ],
    "player_start": [1,1],
    "exit_pos": [12,7],
    "jelly_count": 5,
    "enemies": [
      { "pos": [6,2], "speed": 2.0, "patrol": [[6,2],[6,6]] },
      { "pos": [10,3], "speed": 2.0, "patrol": [[10,3],[10,7]] }
    ]
  }
  